11111111111111111111
1111111P011111111111
11111110C11111111111
11000C00000C0000C001
10000000000000000011
1C0000C00000C0000011
1000C111111000000011
111111111111100C1111
1111111111111E111111
11111111111111111111
